1111111111111111111111111111111
1C0000G000010GC00100000G00000E1
1011011101010111010110110111011
1011011101010000010110110001011
100000C001000111010000C10101001
10111111010100P0000101010101101
1011111101010111111101010101101
10000000000100001000000000000C1
1011111111111110101111111111101
1000000GC000000000000GC00000001
1111111111111111111111111111111