111111111111111111111111111111111
100C0000000000001000000000000C001
101111011110111010111011110111101
1C00000000000000000000000000000C1
101111011110101111101011110111101
100000000000100010001000000000001
111101101110111010111011110110111
111101101110100000001011110110111
1E00000000001011011010000000000E1
1111011011101010P0101011111010111
111101101110101111101011111010111
1C00000000000000000000000000000C1
101111011101111111111101110111101
100001011100000010000001110100001
1011C00000000000000000000000C1101
101111011110101111101011110111101
100000000000000000000000000000001
101111011110111010111011110111101
100C000000000000100000000000C0001
111111111111111111111111111111111