111111111111111111111111111111111111111111111111111111111111111111111111111111111111111111111111111111111111111111111111111111111111
1P00000000000000000000000000000000000000000000000000000000000000000000000000000000000000100000000000000000000000000001010000000E1001
101111111111111110111111111111111111111101000101000000000000010100000000101000101000000010000000000000000000000000000101000000000001
10100000000000001010000000000000000000010100010100000C000000010100000000101000101000000010000000000000001010000010100101000000000001
101000000000000010100000000000000000000101000101000000000000010100000000101000101000000010000000000000001010000010100101000000000001
101000000000000010100000000000000000000101000101000000000000010100000000101000101000000010000000000000001010000010100101000000000001
101000000000000010100101000000000000101000010100010100001010000000010100000000101000101010100000000010101010000010100101010100000001
101000000000000010100101000000000000101000010100010100001010000000010100000000101000101010100000000010101010000010100101010100000001
101000000000000010100101000000000000101000010100010100001010000000010100000000101000101010100000000010101010000010100101010100000001
10100000C000000010100101000000000000101000010100010100001010000000010100000000101000101010100000000010101010000010100100010100000001
101000000000000010100101000000000000101000010100010100001010000000010100000000101000101000100000000010101010000010100000101000000001
100000000000000000000101000000000000101000000000000000001010000000000000000000000000000000100000000010101010000010100000100000000001
100000000000000000000101000000000000101000000000000000001010000000000000000000000000000000100000000010100000000000000000101000000001
100000000C00000000000101000000000000101000000000000000001010000000000000000000000000000000100000000010100000000000000000101000000001
1000000000000000000001010000000000001010000000000000000010100000000000000000000000000000001000000000101000000000000000000010000000E1
111111111111111111111111111111111111111111111111111111111111111111111111111111111111111111111111111111111111111111111111111111111111