111111
1010C1
101001
101001
1P1E01
111111