111111
1000C1
101001
101001
1P0E01
111111