11111111111111111111111111111111111
1P000000001010001010100000000010111
1C1101110010100P10100101110110101C1
10110111001010001010010111011010101
10000000001010001010000000000010101
11110101100010100010111101011010101
10000100000010100010110001000010101
11110111000010100010110111011110101
10010100000010100010100000000E10101
11111111111111111111111111111111111