11111111111111111111111111111111111
1P000000001010001010100000000000001
1C1101110010100P10100101110110101C1
10110111001010001000010111011010101
10000000001010001010000000000010101
11110101100010100000111101011010001
10000100000010100010110001000000101
11110111000010100010110111011100101
10010100000000100010100000000E10001
11111111111111111111111111111111111