11111111111111111111111111111111111
1P010000001010001110110100000000001
1C1101111010100P11100101110110101C1
10110111101010G01110010111011010101
10110000001010001110010100000010101
10110111101010100000111101011010001
10110111G01010100010110001000000101
10110111001010100010110111011100101
10000000000000100010110000000E10001
11111111111111111111111111111111111