1111111111111111111111111
1P00000000000010000000011
1C1101110000P0010111011C1
1011011100000001011101101
1000000000000000000000001
1011010110000001110101101
1000010000000001000100001
1111011100000001011101111
10010100000000000000000E1
1111111111111111111111111