1111111111111111111111111
1P00000000G000000010000E1
1C11111001100P110011010C1
1111111001111011101101101
100G000001100011000000001
1011010101111010001010101
1011010100001010101010001
1011010101101010101110111
10000000011000001000000E1
1111111111111111111111111