1111111111111111111111111111111
1P00000000G1000001G00000E000001
1C1101110101011101011011C1110C1
10110111010100000101101100010C1
100G000001000111010000010101001
1011111101010000000101010101101
1011111101010111111101010101101
1000000000010000100000000000001
1011111111111110101111111111101
1000G0C00000000000000000G0C0001
1111111111111111111111111111111